ASSISTANT	AH S IH S T AH N T
BROWSER	B R AW Z ER
CHATTING	CH AE T IH NG
CLOSE	K L OW S
CLOSE(2)	K L OW Z
COMMANDS	K AH M AE N D Z
EXIT	EH G Z IH T
EXIT(2)	EH K S AH T
FILE	F AY L
GOOGLE	G UW G AH L
LMS	EH L EH M S
MANAGER	M AE N AH JH ER
MANAGER(2)	M AE N IH JH ER
OPEN	OW P AH N
OUTLOOK	AW T L UH K
PSCS	P IY EH S IY S
RETREIVE	R IH T R IY AH V
START	S T AA R T
TEAM	T IY M
VIEWER	V Y UW ER
VOICE	V OY S
YOUTUBE	Y UW T UW B
